{
    "version": 1.2,
    "tiledversion": "1.3.4",
    "orientation": "orthogonal",
    "renderorder": "right-down",
    "width": 20,
    "height": 20,
    "tilewidth": 32,
    "tileheight": 32,
    "infinite": false,
    "nextlayerid": 6,
    "nextobjectid": 1,
    "properties": {},
    "tilesets": [
      {
        "name": "city_tileset",
        "firstgid": 1,
        "tilewidth": 32,
        "tileheight": 32,
        "spacing": 0,
        "margin": 0,
        "columns": 16,
        "image": "city_tileset.png",
        "imagewidth": 512,
        "imageheight": 512,
        "tilecount": 256,
        "tiles": [
          {
            "id": 0,
            "properties": [
              {
                "name": "collides",
                "type": "bool",
                "value": false
              }
            ]
          },
          {
            "id": 1,
            "properties": [
              {
                "name": "collides",
                "type": "bool",
                "value": true
              }
            ]
          }
        ]
      }
    ],
    "layers": [
      {
        "name": "Ground",
        "width": 20,
        "height": 20,
        "opacity": 1,
        "visible": true,
        "data": [
          1,1,1,1,1,1,1,1,1,1,1,1,1,1,1,1,1,1,1,1,
          1,1,1,1,1,1,1,1,1,1,1,1,1,1,1,1,1,1,1,1,
          1,1,2,2,2,2,1,1,1,1,1,1,1,1,2,2,2,2,1,1,
          1,1,2,2,2,2,1,1,1,1,1,1,1,1,2,2,2,2,1,1,
          1,1,2,2,2,2,1,1,1,1,1,1,1,1,2,2,2,2,1,1,
          1,1,2,2,2,2,1,1,1,1,1,1,1,1,2,2,2,2,1,1,
          1,1,1,1,1,1,1,1,1,1,1,1,1,1,1,1,1,1,1,1,
          1,1,1,1,1,1,1,1,1,1,1,1,1,1,1,1,1,1,1,1,
          1,1,1,1,1,1,1,1,3,3,3,3,1,1,1,1,1,1,1,1,
          1,1,1,1,1,1,1,1,3,3,3,3,1,1,1,1,1,1,1,1,
          1,1,1,1,1,1,1,1,3,3,3,3,1,1,1,1,1,1,1,1,
          1,1,1,1,1,1,1,1,3,3,3,3,1,1,1,1,1,1,1,1,
          1,1,1,1,1,1,1,1,1,1,1,1,1,1,1,1,1,1,1,1,
          1,1,1,1,1,1,1,1,1,1,1,1,1,1,1,1,1,1,1,1,
          1,1,2,2,2,2,1,1,1,1,1,1,1,1,2,2,2,2,1,1,
          1,1,2,2,2,2,1,1,1,1,1,1,1,1,2,2,2,2,1,1,
          1,1,2,2,2,2,1,1,1,1,1,1,1,1,2,2,2,2,1,1,
          1,1,2,2,2,2,1,1,1,1,1,1,1,1,2,2,2,2,1,1,
          1,1,1,1,1,1,1,1,1,1,1,1,1,1,1,1,1,1,1,1,
          1,1,1,1,1,1,1,1,1,1,1,1,1,1,1,1,1,1,1,1
        ]
      },
      {
        "name": "Roads",
        "width": 20,
        "height": 20,
        "opacity": 1,
        "visible": true,
        "data": [
          0,0,0,0,0,0,0,0,0,0,0,0,0,0,0,0,0,0,0,0,
          0,0,0,0,0,0,0,0,0,0,0,0,0,0,0,0,0,0,0,0,
          0,0,0,0,0,0,0,0,4,5,5,6,0,0,0,0,0,0,0,0,
          0,0,0,0,0,0,0,0,7,0,0,7,0,0,0,0,0,0,0,0,
          0,0,0,0,0,0,0,0,7,0,0,7,0,0,0,0,0,0,0,0,
          0,0,0,0,0,0,0,0,7,0,0,7,0,0,0,0,0,0,0,0,
          0,0,0,0,0,0,0,0,7,0,0,7,0,0,0,0,0,0,0,0,
          0,0,0,0,0,0,0,0,7,0,0,7,0,0,0,0,0,0,0,0,
          4,5,5,5,5,5,5,5,8,0,0,8,5,5,5,5,5,5,5,6,
          7,0,0,0,0,0,0,0,0,0,0,0,0,0,0,0,0,0,0,7,
          7,0,0,0,0,0,0,0,0,0,0,0,0,0,0,0,0,0,0,7,
          9,5,5,5,5,5,5,5,8,0,0,8,5,5,5,5,5,5,5,10,
          0,0,0,0,0,0,0,0,7,0,0,7,0,0,0,0,0,0,0,0,
          0,0,0,0,0,0,0,0,7,0,0,7,0,0,0,0,0,0,0,0,
          0,0,0,0,0,0,0,0,7,0,0,7,0,0,0,0,0,0,0,0,
          0,0,0,0,0,0,0,0,7,0,0,7,0,0,0,0,0,0,0,0,
          0,0,0,0,0,0,0,0,7,0,0,7,0,0,0,0,0,0,0,0,
          0,0,0,0,0,0,0,0,9,5,5,10,0,0,0,0,0,0,0,0,
          0,0,0,0,0,0,0,0,0,0,0,0,0,0,0,0,0,0,0,0,
          0,0,0,0,0,0,0,0,0,0,0,0,0,0,0,0,0,0,0,0
        ]
      },
      {
        "name": "Parks",
        "width": 20,
        "height": 20,
        "opacity": 1,
        "visible": true,
        "data": [
          0,0,0,0,0,0,0,0,0,0,0,0,0,0,0,0,0,0,0,0,
          0,0,0,0,0,0,0,0,0,0,0,0,0,0,0,0,0,0,0,0,
          0,0,11,11,11,11,0,0,0,0,0,0,0,0,0,0,0,0,0,0,
          0,0,11,12,12,11,0,0,0,0,0,0,0,0,0,0,0,0,0,0,
          0,0,11,12,12,11,0,0,0,0,0,0,0,0,0,0,0,0,0,0,
          0,0,11,11,11,11,0,0,0,0,0,0,0,0,0,0,0,0,0,0,
          0,0,0,0,0,0,0,0,0,0,0,0,0,0,0,0,0,0,0,0,
          0,0,0,0,0,0,0,0,0,0,0,0,0,0,0,0,0,0,0,0,
          0,0,0,0,0,0,0,0,0,0,0,0,0,0,0,0,0,0,0,0,
          0,0,0,0,0,0,0,0,13,13,13,13,0,0,0,0,0,0,0,0,
          0,0,0,0,0,0,0,0,13,14,14,13,0,0,0,0,0,0,0,0,
          0,0,0,0,0,0,0,0,0,0,0,0,0,0,0,0,0,0,0,0,
          0,0,0,0,0,0,0,0,0,0,0,0,0,0,0,0,11,11,0,0,
          0,0,0,0,0,0,0,0,0,0,0,0,0,0,0,0,11,11,0,0,
          0,0,0,0,0,0,0,0,0,0,0,0,0,0,0,0,0,0,0,0,
          0,0,0,0,0,0,0,0,0,0,0,0,0,0,0,0,0,0,0,0,
          0,0,0,0,0,0,0,0,0,0,0,0,0,0,0,0,0,0,0,0,
          0,0,0,0,0,0,0,0,0,0,0,0,0,0,0,0,0,0,0,0,
          0,0,0,0,0,0,0,0,0,0,0,0,0,0,0,0,0,0,0,0,
          0,0,0,0,0,0,0,0,0,0,0,0,0,0,0,0,0,0,0,0
        ]
      },
      {
        "name": "Buildings",
        "width": 20,
        "height": 20,
        "opacity": 1,
        "visible": true,
        "data": [
          0,0,0,0,0,0,0,0,0,0,0,0,0,0,0,0,0,0,0,0,
          0,15,0,0,0,0,16,0,0,0,0,0,0,17,0,0,0,0,18,0,
          0,0,0,0,0,0,0,0,0,0,0,0,0,0,15,0,0,0,0,0,
          0,0,0,0,0,0,0,0,0,0,0,0,0,0,0,0,0,0,0,0,
          0,0,0,0,0,0,0,0,0,0,0,0,0,0,0,0,0,0,0,0,
          0,0,0,0,0,0,0,0,0,0,0,0,0,0,15,0,0,0,0,0,
          0,16,0,0,0,0,15,0,0,0,0,0,0,17,0,0,0,0,16,0,
          0,0,0,0,0,0,0,0,0,0,0,0,0,0,0,0,0,0,0,0,
          0,0,0,0,0,0,0,0,0,0,0,0,0,0,0,0,0,0,0,0,
          0,0,0,0,0,0,0,0,0,0,0,0,0,0,0,0,0,0,0,0,
          0,0,0,0,0,0,0,0,0,0,0,0,0,0,0,0,0,0,0,0,
          0,0,0,0,0,0,0,0,0,0,0,0,0,0,0,0,0,0,0,0,
          0,17,0,0,0,0,18,0,0,0,0,0,0,15,0,0,0,0,17,0,
          0,0,0,0,0,0,0,0,0,0,0,0,0,0,0,0,0,0,0,0,
          0,0,15,0,0,0,0,0,0,0,0,0,0,0,0,0,0,0,0,0,
          0,0,0,0,0,0,0,0,0,0,0,0,0,0,0,0,0,0,0,0,
          0,0,15,0,0,0,0,0,0,0,0,0,0,0,0,0,0,0,0,0,
          0,18,0,0,0,0,17,0,0,0,0,0,0,16,0,0,0,0,18,0,
          0,0,0,0,0,0,0,0,0,0,0,0,0,0,0,0,0,0,0,0,
          0,0,0,0,0,0,0,0,0,0,0,0,0,0,0,0,0,0,0,0
        ]
      },
      {
        "name": "Details",
        "width": 20,
        "height": 20,
        "opacity": 1,
        "visible": true,
        "data": [
          0,0,0,0,0,0,0,0,0,0,0,0,0,0,0,0,0,0,0,0,
          0,0,0,0,0,0,0,0,0,19,20,0,0,0,0,0,0,0,0,0,
          0,0,0,0,0,0,0,0,0,0,0,0,0,0,0,0,0,0,0,0,
          0,0,0,21,0,0,0,0,0,0,0,0,0,0,0,0,22,0,0,0,
          0,0,0,0,0,0,0,0,0,0,0,0,0,0,0,0,0,0,0,0,
          0,0,0,0,0,21,0,0,0,0,0,0,0,0,0,0,0,0,0,0,
          0,0,0,0,0,0,0,0,0,0,0,0,0,0,0,0,0,0,0,0,
          0,0,0,0,0,0,0,0,0,23,24,0,0,0,0,0,0,0,0,0,
          0,0,0,0,0,0,0,0,0,0,0,0,0,0,0,0,0,0,0,0,
          0,19,20,0,0,0,0,0,0,0,0,0,0,0,0,0,19,20,0,0,
          0,0,0,0,0,0,0,0,0,0,0,0,0,0,0,0,0,0,0,0,
          0,0,0,0,0,0,0,0,0,23,24,0,0,0,0,0,0,0,0,0,
          0,0,0,0,0,0,0,0,0,0,0,0,0,0,0,0,0,0,0,0,
          0,0,0,0,22,0,0,0,0,0,0,0,0,0,0,21,0,0,0,0,
          0,0,0,0,0,0,0,0,0,0,0,0,0,0,0,0,0,0,0,0,
          0,0,0,0,0,0,0,0,0,0,0,0,0,0,0,0,0,22,0,0,
          0,0,0,0,0,0,0,0,0,19,20,0,0,0,0,0,0,0,0,0,
          0,0,0,0,0,0,0,0,0,0,0,0,0,0,0,0,0,0,0,0,
          0,0,0,22,0,0,0,0,0,0,0,0,0,0,0,0,21,0,0,0,
          0,0,0,0,0,0,0,0,0,0,0,0,0,0,0,0,0,0,0,0
        ]
      }
    ]
  }